11111111111111111111111
10000000000000000000001
10100000001111100000001
10000000001   000000001
10000000001101110000001
1000000001000000000S001
11111111111111111111111