11111111111111111111111
10000000000000000000001
10100000001111100000001
10000000001   000000001
100000000011011100000000000000
1000000001000000000S001
11111111111111111111111