NO ./textures/colorstone.xpm
SO ./textures/greystone.xpm
WE ./textures/redbrick.xpm
EA ./textures/wood.xpm

F 177,178,177
C 177,177,177

11111111111111111111111111111
10000000000000000000000000001
110100000000010000001000000001
110000000000000000000000000001
10000000000W100000010000000011
10000000000000000000000000001
11111111111111111111111111111
