NO ./textures/colorstone.xpm
SO ./textures/greystone.xpm
WE ./textures/redbrick.xpm
EA ./textures/wood.xpm

F 177,178,177
C 174,177,177

11111111111111111111111111110
10000000000000000000000000001
11010000000001000000100000001
10000000000N00000000000000001
10000000000100000010000000011
1000000000000000000000000001
11111111111111111111111111111
